..P......W
....G.....
..P.......
..........
...P......
.....W....
.....G....
..........
.P........
..........