----------
-P---P----
-P-W------
----------
----------
---------G
----------
----------
--------W-
--------P-
