-------W--
---P------
---P------
------P-P-
--------WP
----------
-P--P--P--
-P----P---
--G-------
------P---
