---P---P-P
--P-------
-----W----
-------GP-
----W-----
-PP-------
----------
-----P----
-P--------
---------P
